1111111
1P000C1
1111111
100E001
1111111
