1111111
1000P01
100C0C1
100E001
1111111
