1111111111111111111111111111111111
100000000000000C00000C000000000001
1010010100100000101001000000010101
1010010010101010001001000000010101
1P0000000C00C0000000000000000000C1
1111111111111111111111111111100111
1000000000000000000000000000100001
1000000000000000000000C000E0100001
1000000000000000000000000000100001
1011111111111111111111111111100001
101C00001C00001C000001C000001C0001
1010000000000000000000000000000001
100001C00001000001C0000001C0000001
1111111111111111111111111111111111
