11111111111111111111111
10000000000C00000000001
1000P000000000000000001
10000001000000010000CC1
10000001000000010000001
10000000000000000000001
10000000000000000000001
1000C001000000010000001
10000001000000010000001
10000000000000000000E01
10000000000C00M00000001
11111111111111111111111
