1111111111111111
100000C000000001
10P0000000C00001
1000101001100001
1000101010010001
10C0111000100001
1000001001000001
1000001011110001
1000000C00000E01
100C000000000001
1111111111111111
